1111111111
1000001001
1000001001
1000001001
1000001001
1000001001
1000001001
1001001001
1001001001
1111111111