1111111111
1000001001
1000001001
1000001001
1000001001
1000001001
1000001001
1010001001
1010001001
1111111111