1111111
1010101
1000101
1010101
1111111